305,425
700,620
860,550
890,520
920,520
1070,450
1540,680

P,10

14,12
#####O##OO####
####O#O#O##O#O
#####OOOOO#OOO
##O#OO########
OOO##O#OOO#OOO
O#O#OO#O#O#OOO
OOO########OOO
O#OOOO#OOOOO#O
OOOOOO#OOOOOOO
#######OO#OO##
OO#OOOO###OO##
OOOO#OOOOOOO#O

124,62
147,506
890,135
1756,568
1014,939
